+---+---+---+---+---+
| A |               |
+   +   +   +---+   +
    |   |     w |   |
+   +---+   +   +   +
|   |   z       |   |
+   +   +---+   +   +
|   | S         |   |
+   +---+---+---+   +
|                   |
+---+---+---+---+---+









