11111111111
1A100000001
10101011101
1010100w101
10111010101
1010z000101
10101110101
101S0000101
10111111101
10000000001
11111111111